{
  "tiles":
  [
    ".... .... .... .... | .... .... .... ....",
    ".... .... .... .... | .... ..g. .... ....",
    ".... .... .... .... | ..g. .... .... ....",
    ".... .... .... .... | ....g.... .... ....",
    ".... .... .... .... | ....g.... .... ....",
    ".... .... .... .... | g... ...g .... ...."
  ]
}
